advertise              = advertize                    (normal)
advertisements         = advertizements               (normal)
advertiser             = advertizer                   (normal)
advertisers            = advertizers                  (normal)
advertising            = advertizing                  (normal)
advertisings           = advertizings                 (normal)

advise                 = advize                       (normal)
adviser                = advizer                      (normal)
advisers               = advizers                     (normal)
advises                = advizes                      (normal)
advisory               = advizory                     (normal)

aluminium	=aluminum      (very high)

analyse		=analyze        (very high)
analysed               = analyzed                     (normal)
analyser               = analyzer                     (normal)
analysrs              = analyzers                    (normal)
analysing              = analyzing                    (normal)

apologise   =apologize      (very high)
apprise                = apprize                      (normal)

authorised             = authorized                   (normal)

behaviour    =behavior      (very high)
behavioural  =behavioral    (very high)
behaviourism            = behaviorism                 (normal)
behaviourist            = behaviorist                 (normal)
behaviours              = behaviors                   (normal)

catalogue     =catalog      (very high)
cataloguers             = catalogers                  (normal)
cataloguing             = cataloging                  (normal)
catalogues               = catalogs                   (normal)

centre                 = center                       (normal)
centred               = centered                      (normal)
centres                = centers                      (normal)
centralized            = centralised                  (normal)
characterization       = characterisation             (normal)
characterizations      = characterisations            (normal)
characterize           = characterise                 (normal)
characterized          = characterised                (normal)
characterizing         = characterising               (normal)
chastise               = chastize                     (normal)
circumcise             = circumcize                   (normal)
civilization           = civilisation                 (normal)
civilizations          = civilisations                (normal)
civilized              = civilised                    (normal)
civilizing             = civilising                   (normal)

colonization           = colonisation                 (very high)
colonize               = colonise                     (very high)
colonized              = colonised                    (normal)
colonizing             = colonising                   (normal)

colourants              = colorants                   (normal)
colouration             = coloration                  (normal)
coloured                = colored                     (normal)
colouring               = coloring                    (normal)
colours                 = colors                      (very high)

commercialization      = commercialisation            (normal)
commercialize          = commercialise                (normal)

comprise               = comprize                     (normal)
comprised              = comprized                    (normal)
comprises              = comprizes                    (normal)
comprising             = comprizing                   (normal)
compromise             = compromize                   (normal)
compromised            = compromized                  (normal)
compromising           = compromizing                 (normal)

computerization        = computerisation              (normal)
computerize            = computerise                  (normal)
computerized           = computerised                 (normal)
computerizing          = computerising                (normal)

conceptualizing        = conceptualising              (normal)

containerization       = containerisation             (normal)
containerize           = containerise                 (normal)
containerized          = containerised                (normal)

councillor   =councilor     (very high)

counselling             = counseling                  (normal)
counsellor              = counselor                   (normal)
counsellors             = counselors                  (normal)

cosy        =cozy           (very high)

criticise   =criticize      (very high)

crystallization        = crystallisation              (normal)
crystallize            = crystallise                  (normal)
crystallized           = crystallised                 (normal)

decentralization       = decentralisation             (normal)
decentralize           = decentralise                 (normal)
decentralized          = decentralised                (normal)
decimalization         = decimalisation               (normal)
decimalize             = decimalise                   (normal)
decimalized            = decimalised                  (normal)

demeanour    =demeanour      (very high)
demise                 = demize                       (normal)

denationalization      = denationalisation            (normal)
denationalize          = denationalise                (normal)
denationalized         = denationalised               (normal)

dependant   =dependent      (very high)

devise                 = devize                       (normal)

dialogue      =dialog       (very high)
dialogues                = dialogs                    (very high)
diarrhoea    =diarrhea      (very high)
digitalization         = digitalisation               (normal)
digitization           = digitisation                 (normal)
digitize               = digitise                     (normal)
digitized              = digitised                    (normal)

encyclopaedia=encyclopedia  (very high)
encyclopaedias          = encyclopedias               (normal)
encyclopaedic           = encyclopedic                (normal)

endeavour    =endeavor      (very high)
endeavours              = endeavors                   (normal)


equalization           = equaliszation                 (normal)
equalize               = equalise                     (normal)
equalized              = equalised                    (normal)

excise                 = excize                       (normal)
exercise               = exercize                     (normal)
exercised              = exercized                    (normal)
exercises              = exercizes                    (normal)
exercising             = exercizing                   (normal)

favour       =favor         (very high)
favourite    =favorite      (very high)

fertilization          = fertilisation                (normal)
fertilize              = fertilise                    (normal)
fertilized             = fertilised                   (normal)
fertilizer             = fertiliser                   (normal)
fertilizers            = fertilisers                  (normal)
fertilizing            = fertilising                  (normal)

fibre       =fiber          (very high)
fibreglass  =fiberglass     (very high)
fibres                 = fibers                       (normal)

flavour      =flavor        (very high)
flavouring              = flavoring                   (normal)
flavourings             = flavorings                  (normal)
flavours                = flavors                     (normal)

fluidization           = fluidisation                 (normal)
fluidized              = fluidised                    (normal)

generalization         = generalisation               (normal)
generalizations        = generalisations              (normal)
generalize             = generalise                   (normal)
generalized            = generalised                  (normal)
generalizing           = generalising                 (normal)

glamour      =glamor        (very high)

globalization          = globalisation                (normal)
globalize              = globalise                    (normal)
globalized             = globalised                   (normal)
globalizing            = globalising                  (normal)


honour       =honor         (very high)
honourable   =honorable     (very high)
humour       =humor         (very high)

improvisation          =  improvization               (normal)
improvisations         =  improvizations              (normal)
improvise              =  improvize                   (normal)
improvised             =  improvized                  (normal)
improvising            =  improvizing                 (normal)
incise                 =  incize                      (normal)
incised                =  incized                     (normal)

individualization      =  individualisation           (normal)
individualize          =  individualise               (normal)
individualized         =  individualised              (normal)
individualizing        =  individualising             (normal)
industrialization      =  industrialisation           (normal)
industrialize          =  industrialise               (normal)
industrialized         =  industrialised              (normal)
industrializing        =  industrialising             (normal)

internationalization   =  internationalisation        (normal)
internationalize       =  internationalise            (normal)
internationalized      =  internationalised           (normal)
internationalizing     =  internationalising          (normal)
ionizing               =  ionising                    (normal)

labour       =labor         (very high)
labouring               =  laboring                   (normal)
labours                 =  labors                     (normal)

liberalization         =  liberalisation              (normal)
liberalize             =  liberalise                  (normal)


license     =licence        (very high)
licenses               =  licences                    (normal)
liqurice    =licorice      (very high)

localization           =  localisation                (normal)
localize               =  localise                    (normal)
localized              =  localised                   (normal)
localizing             =  localising                  (normal)


maximization           =  maximisation                (normal)
maximize               =  maximise                    (normal)
maximized              =  maximised                   (normal)
maximizing             =  maximising                  (normal)

meagre      =meager         (very high)

mechanization          =  mechanisation               (normal)
mechanize              =  mechanise                   (normal)
mechanized             =  mechanised                  (normal)
mechanizing            =  mechanising                 (normal)

mediaeval    =medieval      (very high)

memorise    =memorize       (very high)
merchandise            =  merchandize                 (normal)
merchandising          =  merchandizing               (normal)

metre       =meter          (very high)
metres                 =  meters                      (normal)

miniaturization        =  miniaturisation             (normal)
miniaturize            =  miniaturise                 (normal)
miniaturized           =  miniaturised                (normal)
miniaturizing          =  miniaturising               (normal)
minimization           =  minimisation                (normal)
minimize               =  minimise                    (normal)
minimized              =  minimised                   (normal)
minimizing             =  minimising                  (normal)

misdemeanour =misdemeanor   (very high)

neighbour    =neighbor      (very high)
neighbourhood=neighborhood  (very high)
neighbourhoods          =  neighborhoods              (normal)
neighbourly  =neighborly    (very high)
neighbours              =  neighbors                  (normal)

neurobehavioural        =  neurobehavioral            (normal)

odour        =odor          (very high)
offence     =offense        (very high)

organization           =  organisation                (normal)
organizational         =  organisational              (normal)
organizations          =  organisations               (normal)
organize               =  organise                    (normal)
organized              =  organised                   (normal)
organizer              =  organiser                   (normal)
organizers             =  organisers                  (normal)
organizing             =  organising                  (normal)

paediatric              =  pediatric                  (normal)
paediatrician           =  pediatrician               (normal)
paediatricians          =  pediatricians              (normal)
paediatrics  =pediatrics    (very high)

professionalization    =  professionalisation         (normal)

programme     =program      (very high)

quantization           =  quantisation                (normal)
quantize               =  quantise                    (normal)
quantized              =  quantised                   (normal)
quantizing             =  quantising                  (normal)

rationalization        =  rationalisation             (normal)
rationalize            =  rationalise                 (normal)
rationalized           =  rationalised                (normal)
rationalizing          =  rationalising               (normal)
realization            =  realisation                 (normal)
realizations           =  realisations                (normal)
realize     =realise        (very high)
realized               =  realised                    (normal)
realizing              =  realising                   (normal)

recognized             =  recognised                  (normal)
recognizing            =  recognising                 (normal)

regionalization        =  regionalisation             (normal)
reorganization         =  reorganisation              (normal)
reorganizations        =  reorganisations             (normal)
reorganize             =  reorganise                  (normal)
reorganized            =  reorganised                 (normal)
reorganizing           =  reorganising                (normal)
reurbanization         =  reurbanisation              (normal)
revitalization         =  revitalisation              (normal)
revitalize             =  revitalise                  (normal)
revitalized            =  revitalised                 (normal)
revitalizing           =  revitalising                (normal)
revolutionize          =  revolutionise               (normal)
revolutionized         =  revolutionised              (normal)

routinization          =  routinisation               (normal)

rumour                  =  rumor                      (normal)
rumours                 =  rumors                     (normal)
sabre       =saber          (very high)

saviour      =savior        (very high)
saviours                =  saviors                    (normal)
savouries               =  savories                   (normal)
savoury                 =  savory                     (normal)

scandalize             =  scandalise                  (normal)
secularization         =  secularisation              (normal)
securitization         =  securitisation              (normal)


socialization          =  socialisation               (normal)
socialize              =  socialise                   (normal)
socialized             =  socialised                  (normal)
socialising            =  socialising                 (normal)
solarize               =  solarise                    (normal)
solemnization          =  solemnisation               (normal)

specialization         =  specialisation              (normal)
specializations        =  specialisations             (normal)
specialize             =  specialise                  (normal)
specialized            =  specialised                 (normal)
specializing           =  specialising                (normal)

spectre     =specter        (very high)
splendour    =splendor      (very high)

stabilization          =  stabilisation               (normal)
stabilize              =  stabilise                   (normal)
stabilized             =  stabilised                  (normal)
stabilizer             =  stabiliser                  (normal)
stabilizers            =  stabilisers                 (normal)
stabilizing            =  stabilising                 (normal)

standardization        =  standardisation             (normal)
standardize            =  standardise                 (normal)
standardized           =  standardised                (normal)
standardizing          =  standardising               (normal)

sterilization          =  sterilisation               (normal)
sterilize              =  sterilise                   (normal)
sterilized             =  sterilised                  (normal)
sterilizing            =  sterilising                 (normal)

subsidization          =  subsidisation               (normal)
subsidize              =  subsidise                   (normal)
subsidized             =  subsidised                  (normal)
subsidizing            =  subsidising                 (normal)

summarize              =  summarise                   (normal)
summarized             =  summarised                  (normal)
summarizing            =  summarising                 (normal)

supervise              =  supervize                   (normal)
supervised             =  supervized                  (normal)
supervising            =  supervizing                 (normal)
supervisor             =  supervizor                  (normal)

surprise               =  surprize                    (normal)
surprising             =  surprizing                  (normal)

synchronization        =  synchronisation             (normal)
synchronize            =  synchronise                 (normal)
synchronized           =  synchronised                (normal)
synchronizing          =  syncrhonising               (normal)

synthesize             =  synthesise                  (normal)
synthesized            =  synthesised                 (normal)
synthesizer            =  synthesiser                 (normal)
synthesizers           =  synthesisers                (normal)
systemization          =  systematisation             (normal)
systemize              =  systemise                   (normal)
systemized             =  systematised                (normal)

technologizing         =  technologising              (normal)

televise               =  televize                    (normal)
televised              =  televized                   (normal)
televising             =  televizing                  (normal)

theorize               =  theorise                    (normal)
theorizing             =  theorising                  (normal)

tranquillized          =  tranquillised               (normal)
tranquillizer          =  tranquilliser               (normal)
tranquillizing         =  tranquillising              (normal)

tumours                 =  tumors                     (normal)

unionization           =  unionisation                (normal)
unionize               =  unionise                    (normal)
unionized              =  unionised                   (normal)
unorganized            =  unorganised                 (normal)


urbanization           =  urbanisation                (normal)
urbanize               =  urbanise                    (normal)
urbanized              =  urbanised                   (normal)
utilization            =  utilisation                 (normal)
utilize                =  utilise                     (normal)
utilized               =  utilised                    (normal)
utilizer               =  utiliser                    (normal)
utilizes               =  utilises                    (normal)
utilizing              =  utilising                   (normal)

vaporization           =  vaporisation                (normal)
vaporize               =  vaporise                    (normal)
vaporized              =  vaporised                   (normal)

vapours                 =  vapors                     (normal)

vectorized             =  vectorised                  (normal)

visualization          =  visualisation               (normal)
visualize              =  visualise                   (normal)
visualized             =  visualised                  (normal)
visualizer             =  visualiser                  (normal)
visualizing            =  visualising                 (normal)

vocalization           =  vocalisation                (normal)
vocalize               =  vocalise                    (normal)
vocalized              =  vocalised                   (normal)
vocalizer              =  vocaliser                   (normal)
vocalizes              =  vocalises                   (normal)
vocalizing             =  vocalising                  (normal)

watercolour             =  watercolor                 (normal)
watercolours            =  watercolors                (normal)
